1 2 1 2 1 2 1 2 1 2 1 2 1 2 1 2 1 2 1
2 1 2 4 4 4 4 4 4 4 4 4 4 4 4 4 2 1 2
1 2 1 4 2 1 2 1 2 1 2 1 2 1 2 4 1 2 1
2 1 2 4 1 2 1 2 1 2 1 2 1 2 1 4 2 1 2
1 2 1 4 2 1 2 1 2 1 2 1 2 1 2 4 1 2 1
2 1 2 4 1 2 1 2 1 2 1 2 1 2 1 4 2 1 2
1 2 1 4 2 1 2 1 2 1 2 1 2 1 2 4 1 2 1
2 1 2 4 1 2 1 2 1 2 1 2 1 2 1 4 2 1 2
1 2 1 4 2 1 2 1 2 1 2 1 2 1 2 4 1 2 1
2 1 2 4 1 2 1 2 1 2 1 2 1 2 1 4 2 1 2
1 2 1 4 2 1 2 1 2 1 2 1 2 1 2 4 1 2 1
2 1 2 4 1 2 1 2 1 2 1 2 1 2 1 4 2 1 2
1 2 1 4 2 1 2 1 2 1 2 1 2 1 2 4 1 2 1
2 1 2 4 1 2 1 2 1 2 1 2 1 2 1 4 2 1 2
1 2 1 4 2 1 2 1 2 1 2 1 2 1 2 4 1 2 1
2 1 2 4 1 2 1 2 1 2 1 2 1 2 1 4 2 1 2
3 3 3 4 3 3 3 3 3 3 3 3 3 3 3 4 3 3 3
1 2 1 4 2 1 2 1 2 1 2 1 2 1 2 4 1 2 1
2 1 2 4 1 2 1 2 1 2 1 2 1 2 1 4 2 1 2
1 2 1 4 2 1 2 1 2 1 2 1 2 1 2 4 1 2 1
2 1 2 4 1 2 1 2 1 2 1 2 1 2 1 4 2 1 2
1 2 1 4 2 1 2 1 2 1 2 1 2 1 2 4 1 2 1
2 1 2 4 1 2 1 2 1 2 1 2 1 2 1 4 2 1 2
1 2 1 4 2 1 2 1 2 1 2 1 2 1 2 4 1 2 1
2 1 2 4 1 2 1 2 1 2 1 2 1 2 1 4 2 1 2
1 2 1 4 2 1 2 1 2 1 2 1 2 1 2 4 1 2 1
2 1 2 4 1 2 1 2 1 2 1 2 1 2 1 4 2 1 2
1 2 1 4 2 1 2 1 2 1 2 1 2 1 2 4 1 2 1
2 1 2 4 1 2 1 2 1 2 1 2 1 2 1 4 2 1 2
1 2 1 4 2 1 2 1 2 1 2 1 2 1 2 4 1 2 1
2 1 2 4 1 2 1 2 1 2 1 2 1 2 1 4 2 1 2
1 2 1 4 4 4 4 4 4 4 4 4 4 4 4 4 1 2 1
2 1 2 1 2 1 2 1 2 1 2 1 2 1 2 1 2 1 2